NO texture/murgpt.xpm
SO texture/murgpt.xpm
EA texture/murgp_two.xpm
WE texture/murgp_two.xpm

F 109,87,82
C 0,0,0

11111111111111111111111111111111111111111111111111111111111111111111
10000000100000000000000010000000000000000000000000000000000100000001
10000000000000000000000010000000000000000000000000000000000100000001
10000000100001111111111111111111000111111111111111111001111111011111
11111111100001000000001000000000000000100000010000000000000100000001
10000000000001000000001000000000000000100000010000000000000100000001
10000011110111111111111000000000000000100000010000000000000100000001
100000100000010000000010000000000000001000000100000N0000000000000001
10000010000000000000000000000000000000100000010000000000000000000001
10000010000001000000001000000000000000111011110000000000000000000001
11101111110111111111111000000000000000100000010000000000000100000001
10000010000000000000001000000000000000000000010000000000000100000001
10000010000000000000001000000000000000100000011111110111111100000001
10000000000000000000001000000000000000100000010000000000000100000001
10000011111111011111111111111110011111111111110000000000000000000001
10000010000000000000000000000000000000000000110000000000000100000001
11111111111111111111111111111111111111111111111111111111111111111111