NO texture/murgpt.xpm
SO texture/murgpt.xpm
EA texture/murgp_two.xpm
WE texture/murgp_two.xpm

F 109,87,82
C 0,0,0

            111111111111111111111111
            100000001000000000010S01
            100000000000000000010001 
            111100111111111000010001
            100000000000001000010001
            100000001111111100010001
            100000000000000000000001   
            100001111111111111110001
            100001000000000001000001
111111111111100001000000000000000001
100000000000000001000000000001111111
10001111111111111100000000000001
10000000000000000000000000011111
1111111111111100000000000001
    100000000100000000000001
    100000000000000000000001
    100000000100000000000001
    111111111111111111111111