NO texture/murgpt.xpm
SO texture/murgpt.xpm
EA texture/murgp_two.xpm
WE texture/murgp_two.xpm

F 178, 186, 187
C 0,0,0

            111111111111111111111111
            100000001000000000010S01
            10000000D000000000010001 
            1111DD111111111000010001
            100000000000001000010001   
            100000001111111100010001
            1000000000000000000D0001   
            100001111111111111110001
            100001000000000001000001
11111111111110000100000000000D000001
100000000000000001000000000001111111
10001111111111111100000000000001
1000D000000000000000000000011111
1111111111111100000000000001
    100000000100000000000001
    100000000D00000000000001
    100000000100000000000001
    111111111111111111111111