NO texture/murgpt.xpm
SO texture/murgpt.xpm
EA texture/murgp_two.xpm
WE texture/murgp_two.xpm

F 178, 186, 187
C 0,0,0

11111111111111111111111111111111111111111111111111111111111111111111
100000001000000000000000D0000000000000000000D00000000000000100000001
10000000D000000000000000D0000000000000000000D00000000000000100000001
10000000100001111111111111111111DDD111111111111111111DD1111111DDD111
1111111110000100000000D000000000000000100000010000000000000100000001
1000000000000100000000D000000000000000100000010000000000000100000001
1000001111D1111111111110000000000000001000000D0000000000000100000001
100000100000010000000010000000000000001000000D0000000000N00D00000001
1000001000000D00000000D000000000000000100000010000000000000D00000001
10000010000001000000001000000000000000111D11110000000000000D00000001
111D111111D111111111111000000000000000100000010000000000000100000001
10000010000000000000001000000000000000D000000D0000000000000100000001
1000001000000000000000100000000000000010000001111111DD11111100000001
100000D0000000000000001000000000000000100000010000000000000100000001
10000011111111D1111111111111111DD11111111111110000000000000D00000001
10000010000000000000000000000000000000000000110000000000000100000001
11111111111111111111111111111111111111111111111111111111111111111111