111111111111111111111111111111
1MT000110T000M110T000110T00001
101T000000010T0001T000000010T1
100TT01TTT0T000000TT01TTT0T0M1
1T0000T0MT010000T0000T00T01011
1T00T110010TPMX0T00T110010T011
10000010T10001110000010T100011
10TTT000011000110TTT0000110001
1001000T0111T011001000T0111T01
1001000T0111T011001000T0111T01
10M1000T0111T0110M100MT0111TM1
111111111111111111111111111111