111111111111111
10TM00110TMP0P1
101T000000010T1
100TT01TTT0T001
1T0000T0MT01011
1T00T110010T011
10000010T100011
10TTT0000110001
10X1M00T0111TM1
111111111111111