111111111111111
10TM00110TM1001
101T00000000001
100TT010100T001
1T000001P101011
1T00T110100T011
10000010T100011
1T0TT0000110001
10X1M00T0111TM1
111111111111111